1111111111
1ECCCPCCQ1
1111111111