111111111111111
100C0001C0000C1
100C00C1000P001
10CEC1111111111
101C100C0000001
100100000C000C1
100000B00000001
111111111111111