111111111111111
100C0000C0000C1
100000C00000001
100001111110001
10B0000C11E0001
1000C0010C110C1
10000001P000101
111111111111111