111111111111111
1CECB100C000PC1
111111111111111