111111111111111
100C0010C0000C1
10000100000P001
10000100000B001
100001CC0000001
1000C1000C000C1
100001E00000001
111111111111111