111111111111111
1PE10000C0000C1
100100000000001
100100000000001
1C0100000B00001
111111111111111