111111111111111
1C0C0010C0000C1
101111011000001
1000E0000100B01
1000100P0100001
100010000100001
100011C111000C1
100000100000001
111111111111111