111111111111111
1PEC1000C00B0C1
111111111111111