111111111111110
1E0C0000C0000C1
100000C0000P001
100001111110001
1000000C0000001
1000C0000C000C1
100BB0000000001
111111111111111