1111111111111
1111110111111
1111110111111
10010000000C1
1000011111001
1P0011E000001
1111110C11111
1111110111111
111111000BB11
1111111111111