111111111111111
1E1C0000C0000C1
101000C0000P001
1C0001111111111
101111C00000001
100001111111101
100100000BB00C1
111111111111111