1111111111111
1011CCBCCCCB1
11CCC111111C1
1PC011ECCCCC1
1111111111111