111111111111111
1EBC0000C0000P1
111111111111111