111111111111111
1EPCCCCCBCCCCC1
111111111111111