111111111111111
1ECBCCCCCCCCCP1
111111111111111