111111111111111111111111111111
111111111111111111111111111111
111111111111111111111111111111
11111111111111C111111111BB1111
111111B111111PCE11111111111111
11111111111111C1111111111B1111
111111111111111111111111111111
111111111111111111111111111111