111111111111111
1E0C0000C0000C1
100000C0000P001
111111111111111
1000B00000B0001
100000000B00001
100000BBBB00001
111111111111111