11111111111111111111111111111111111111
11111111111111111111111111111111111111
11111111111111111111111111111111111111
111111111111111B1111111111111111111111
111E000000CCCCCCCCCCCCCC00011111111111
111111111B11111B1111111111011111111111
11111111111111111111111111011111111111
111111111111111111111111111100P1111111
11111111111111111111111111111111111111
