11111111111111111111111111111111111111
1111111111111111B111111111111111111111
11111111111111110111111111111111111111
11111111111111110111111111111111111111
111E001000CCCCCCCCCCCCCC00011111111111
11111111111111111111111111011111111111
11111111111111111111111111011111111111
111111111111111111111111110C00P1111111
11111111111111111111111111111111111111
