11111111111111111111111111111111111111
111111111111111111C1111111111111111111
111B11111111111111C1111111111111111111
11101111111111111101111111111111111111
111E010000CCCCCCCCCCCCCC00011111111111
11101111111111111111111111011111111111
111B1111111111111111111111011111111111
1111111111111111111111111100P111111111
11111111111111111111111111111111111111
