1111111111
1EB0000011
1111000C11
1C000C00P1
1111111111