     1
    111
   11111
  1111111
 111111111
11111111111