111111111111111
1B0C0000C0000C1
100000C00000001
100001111110B01
1000000C11E0001
1000C0010C010C1
10000001P000101
111111111111111