111111111111111
1PECB000C0000C1
111111111111111