111111111111111
1E0C0000C0000C1
100000C0000P001
111111111110101
1000000C0000001
1111C0000C000C1
1C00000000BB001
111111111111111