111111111111111
1CECB000C000PC1
111111111111111