111111111111111
1B0C0000C0000C1
100C00C1000P001
10CEC1111111111
1B1C100C0000001
100100000C000C1
100000000000001
111111111111111