111111111111111
1PE00000C0000C1
100100000000001
100100000000001
1C0100000000B01
111111111111111