111111111111111
1E0C0000C0B00C1
100000C00000001
1100000000B0001
1011000C0000001
110011000C000C1
100P00C00000001
111111111111111