111111111111111
1C0C0000C0000C1
101111011000001
1000E0000100001
1000100P0100001
100010000100001
100011C111000C1
1B0000100000B01
111111111111111