1111111111
1EPPCCCC01
1111111111