1111111111
100CCCCCP1
1111111111