111111111111111
1CEC0100C000PC1
111111111111111