11111111111111111111111111111111111111
11111111111111111111111111111111111111
111111111111111111111111111C1111111111
11111111111111111111111111111111111111
111E000000CCCCCCCCCCCCCC00011111111111
11111111111111111111111111011111111111
11111111111111111111111111011111111111
111111111111111111111111110000P1111111
11111111111111111111111111111111111111
