111111111111111
1E0C0000C0000C1
100000C00000001
110000000000001
1011000C0000001
110011000C000C1
100P00C00000001
111111111111111