111111111111111
1E0C0000C0000C1
100000C1100P001
110001100100001
1000000C0100001
1000C1101C000C1
100000010000001
111111111111111