111111111111111
100C0000C0000C1
100000C0000P001
100001111110001
1100000C0000001
1111C0000C000C1
1CE000000000001
111111111111111