11111111111111111111111
10B000010001000001000P1
100000000C10100001C1101
101111100C0001001010001
10000010000010001000001
10000010100010001001111
10100010000000001000011
1010001000001100C1C1001
10000010000000000100101
10000000010000000110001
10000000000000000000011
1E00010B0011000001000C1
11111111111111111111111