111111111111111
1E000C0000000C1
111001000111101
1P1001C0000B001
10C001000111101
101011000000001
10000000B10C0B1
111111111111111