111111111111111
1000100000C0101
100000000000001
100000B010B0001
100000000000001
11C000000000001
100C0C001000001
110010000C00001
1001010C0000001
10B011000000001
100001CCE000P01
111111111111111
