1111111111111111
1P0000000000B0C1
1000C000CC000001
1000000CEC000001
10C0000CCC000001
1000C000000B0001
1C0C0C000000C001
1111111111111111