1111111111111111111111111
10B00001000100001C01000P1
100000000C1010010001C1101
100000000C000001001010001
1000000000001010001000001
1000000010001010001001111
1010000000000000001000011
101000000000110000C1C1001
1000000000000000000100101
1000000001000000000110001
1000000000000000000000011
1E00010B001100000001000C1
1000000000000000000110011
11000C00000C000100000C011
1111111111111111111111111