111111111111111
1C00000000000C1
1110000CC111101
111000CEC001001
10C000CCC111101
100000000000001
1P0CC000000C001
111111111111111