111111111111111
1E001C0000000C1
111001000111101
111001C00001001
10C001000111101
101111000100001
1P000000010C001
111111111111111