1111111111111111111111111
101C0010001000111C1100001
101010101C1010110011C1101
10001C001C001011011111001
1111111011111000011100011
1100000010001110011101111
1110111110101100110100011
111000011000110111C1C1001
1C11110101101101110111101
100000000100000000P110001
1111111111011110111010111
1E000100001100000011000C1
1111010110111011101101111
11000C01100C0011100000C11
1111111111111111111111111